APPVersion=Version 1.8
ApolloClockName=阿波罗纪念钟表
ApolloClockDescribe=为纪念阿波罗登月50周年而制作的一款纪念钟表。
WEBName=行星发动机
WEBDescribe=《流浪地球》行星发动机,推动地球,踏上流浪之旅。
ARShowForSaturnVAndClockName=包装演示
ARShowForSaturnVAndClockDescribe=土星五和Apollo钟表包装演示程序。
PLUMEName=PLUME
PLUMEDescribe=模仿火箭发射场景的智能多功效AR火箭灯。
MobilePowerName=宇航员移动电源
MobilePowerDescribe=宇航员移动电源AR.
SaturnVName=土星五号
SaturnVDescribe=AR生动展现土星五号全部内部结构，亲历阿波罗登月壮举。
QRRepeatTip=请勿重复扫描二维码!
QRBindTip=此二维码绑定设备已满!
QRWrongTip=请扫描正确的二维码!
QRReBindTip=已绑定相同类型,是否替换成此二维码进行重新激活?
way1InputWrong=请输入正确的密钥!
way1InputRepeat=请勿输入重复的密钥!
way1ReBindTip=已绑定相同类型,是否替换成此密钥进行重新激活?
RecogImageTip=正在识别图片中的二维码,请稍候!
DecodeNone=没有识别到二维码,请重新选择图片!
ImgPathEmpty=没有选择图片,请重新进入相册选择图片!
DecodeWrongTip=请选择正确的二维码图片!
PLUMEBlueIOS=系统蓝牙未打开,是否跳转到设置页面?
PLUMEConnecting=PLUME正在连接
PLUMESyncData=正在同步数据...
PLUMEExitTip=PLUME处于关机模式下!
PLUMENotDIYTip=PLUME未处于DIY模式下!
PLUMEAudioBlueNotCon=音频蓝牙未连接!
PLUMEDataBlueNotCon=数据蓝牙未连接!
PLUMESyncingData=正在同步数据,请稍候...
TimeIsRepetition=请不要与已保存的闹钟/留言选择相同的时间!
ClockOutOfRange=闹钟个数已满,请删除或者修改之前的闹钟!
LightOutOfRange=灯光个数已满,请删除或者修改之前的灯光!
VoiceOutOfRange=留言个数已满,请删除或者修改之前的留言!
NotAllowChinese=名称不允许为中文!
VoiceNotRecors=请录音后再保存!
VoiceRing=留言响起,请关闭后再操作APP!
ClockRing=闹钟响起,请关闭后再操作APP!
VoiceNameSame=留言名称重复!
VoiceSetPastTime=选择的时间已过!
RestartBlueOrAPP=需要重启蓝牙或者APP!
VoiceNameEmpty=留言名称不能为空!
BindFailure=绑定失败,请检查网络!
UnBindFailure=解绑失败,请检查网络!
BackRealmodelIsSave=是否保存数据?
NoNetWork=当前没有网络,无法进行此操作!
NotRecordPermissions=请在设置中打开麦克风权限!
EmailInputEmpty=邮箱不能为空!
PWDInputEmpty=密码不能为空!
PWDInputInconsistency=两次密码输入不一致!
EmailHasRegistered=邮箱已经注册!
CallWrong=输入参数错误或者接口调用出错!
PWDWrong=密码错误!
EmailNotRegistered=邮箱未注册!
CodeInputEmpty=验证码不能为空!
CodeWrong=验证码输入错误!
InputNotEmail=邮箱格式不正确!
NotLogin=请登录后再进行此操作!
LoginTip=正在登录...
RegisterTip=正在注册...
ApolloBuyURL=https://www.kickstarter.com/projects/apollo50th/apollo-50th-apollo-ar-clock-and-saturnv-ar-metal-model?ref#1bqhvv
LoginExpired=登录已过期,请重新登录!
SystemMaintenance=系统维护
DownError=下载错误
BoardingCodeEmpty=登机码为空
UserNameEmpty=名字为空
MessageEmpty=登记信息为空
JudgeBoardingCodeState=正在检测登机码状态
ShipTicketGeneration=生成船票
BoardingCodeFinishOrNotExist=活动已经结束或登机码无效
BoardingCodeUsed=登机码已经使用
SaveImageSuccess=保存图片成功,可在相册查看
SaveImageFail=保存图片失败,请重试
NoPhotoPermission=没有相册权限
LandingPointName=猜落点
MrStevenName=整流罩
ShipNameToSpaceName=送你名字上太空
LandingPointDescribe=真的可以猜落点
MrStevenDescribe=真的整流罩
ShipNameToSpaceDescribe=您的名字和留言将被放置在金唱片上，并由天仪研究院的卫星送上太空